 <콘텐츠 구획>
   콘텐츠 구획 요소를 사용하면 문서의 콘텐츠를 논리적인 조각으로 체계화할 수 있습니다. 
   구획 요소를 사용해 탐색을 위한 헤더 및 푸터, 콘텐츠 판별을 위한 제목 요소 등 페이지 콘텐츠의 큰 틀을 잡으세요

<adderss>: HTML <address> 요소는 가까운 HTML 요소의 사람, 단체, 조직 등에 대한 연락처 정보를 나타냅니다.
<article>  : HTML <article> 요소는 문서, 페이지, 애플리케이션, 또는 사이트 안에서 독립적으로 구분해 배포하거나 재사용할 수 있는 구획을 나타냅니다.
<aside>   : HTML <aside> 요소는 문서의 주요 내용과 간접적으로만 연관된 부분을 나타냅니다. 주로 사이드바 혹은 콜아웃 박스로 표현합니다.
<footer> : HTML <footer> 요소는 가장 가까운 구획 콘텐츠나 구획 루트의 푸터를 나타냅니다. 푸터는 일반적으로 구획의 작성자, 저작권 정보, 관련 문서 등의 내용을 담습니다.
<header>: HTML <header> 요소는 소개 및 탐색에 도움을 주는 콘텐츠를 나타냅니다. 제목, 로고, 검색 폼, 작성자 이름 등의 요소도 포함할 수 있습니다.
<h1>, <h2>, <h3>, <h4>, <h5>, <h6> : HTML <h1>–<h6> 요소는 6단계의 구획 제목을 나타냅니다. 구획 단계는 <h1>이 가장 높고 <h6>은 가장 낮습니다.
<main> : HTML <main> 요소는 문서 body의 주요 콘텐츠를 나타냅니다. 주요 콘텐츠 영역은 문서의 핵심 주제나 앱의 핵심 기능에 직접적으로 연결됐거나 확장하는 콘텐츠로 이루어집니다.
<nav> : HTML <nav> 요소는 문서의 부분 중 현재 페이지 내, 또는 다른 페이지로의 링크를 보여주는 구획을 나타냅니다. 자주 쓰이는 예제는 메뉴, 목차, 색인입니다.
HTML <nav> 요소는 문서의 부분 중 현재 페이지 내, 또는 다른 페이지로의 링크를 보여주는 구획을 나타냅니다. 자주 쓰이는 예제는 메뉴, 목차, 색인입니다.
<section> : HTML <section> 요소는 HTML 문서의 독립적인 구획을 나타내며, 더 적합한 의미를 가진 요소가 없을 때 사용합니다.


<텍스트 콘텐츠>
HTML 텍스트 콘텐츠를 사용하여 여는 <body>와 닫는 </body> 태그 사이의 블록이나 콘텐츠 구획을 정리할 수 있습니다. 
해당 콘텐츠의 목적이나 구조 판별에 사용하므로 접근성과 SEO에 중요합니다.
<blockquote>	HTML <blockquote> 요소는 안쪽의 텍스트가 긴 인용문임을 나타냅니다. 주로 들여쓰기를 한 것으로 그려집니다. (외형을 바꾸는 법은 사용 일람을 참고하세요) 인용문의 출처 URL은 cite 특성으로, 출처 텍스트는 cite 요소로 제공할 수 있습니다.
<dd>	HTML <dd> 요소는 정의 목록 요소(dl)에서 앞선 용어(dt)에 대한 설명, 정의, 또는 값을 제공합니다.
<div>	HTML <div> 요소는 플로우 콘텐츠를 위한 통용 컨테이너입니다. CSS로 꾸미기 전에는 콘텐츠나 레이아웃에 어떤 영향도 주지 않습니다.
<dl>	HTML <dl> 요소는 설명 목록을 나타냅니다. <dl>은 dt로 표기한 용어와 dd 요소로 표기한 설명 그룹의 목록을 감싸서 설명 목록을 생성합니다. 주로 용어사전 구현이나 메타데이터(키-값 쌍 목록)를 표시할 때 사용합니다.
<dt>	HTML <dt> 요소는 설명 혹은 정의 리스트에서 용어를 나타냅니다. dl 요소 안에 위치해야 합니다
<figcaption>	HTML <figcaption> 요소는 부모 figure 요소가 포함하는 다른 콘텐츠에 대한 설명 혹은 범례를 나타냅니다.
<figure>	HTML <figure> 요소는 독립적인 콘텐츠를 표현합니다. figcaption 요소를 사용해 설명을 붙일 수 있습니다.
<hr>	HTML <hr> 요소는 이야기 장면 전환, 구획 내 주제 변경 등, 문단 레벨 요소에서 주제의 분리를 나타냅니다.
<li>	HTML <li> 요소는 목록의 항목을 나타냅니다.
<ol>	HTML <ol> 요소는 정렬된 목록을 나타냅니다. 보통 숫자 목록으로 표현합니다.
<p>	HTML <p> 요소는 하나의 문단을 나타냅니다.
<pre>	HTML <pre> 요소는 미리 서식을 지정한 텍스트를 나타내며, HTML에 작성한 내용 그대로 표현합니다.
<ul>	HTML <ul> 요소는 정렬되지 않은 목록을 나타냅니다. 보통 불릿으로 표현합니다.
인라인 텍스트 시멘틱
HTML 인라인 텍스트 시멘틱을 사용해서 단어, 줄, 혹은 아무 부분의 의미나 구조, 스타일을 정의할 수 있습니다.

Element	Description
<a>	HTML <a> 요소(앵커 요소)는 href 특성을 통해 다른 페이지나 같은 페이지의 어느 위치, 파일, 이메일 주소와 그 외 다른 URL로 연결할 수 있는 하이퍼링크를 만듭니다.
<abbr>	HTML <abbr> 요소는 준말 또는 머리글자를 나타냅니다.
<b>	HTML <b> 요소는 독자의 주의를 요소의 콘텐츠로 끌기 위한 용도로 사용합니다. 그 외의 다른 특별한 중요도는 주어지지 않습니다.
<bdi> (en-US)	
<bdo>	HTML <bdo> 요소는 현재 텍스트의 쓰기 방향을 덮어쓰고 다른 방향으로 렌더링 할 때 사용합니다.
<br>	HTML <br> 요소는 텍스트 안에 줄바꿈(캐리지 리턴)을 생성합니다. 주소나 시조 등 줄의 구분이 중요한 내용을 작성할 때 유용합니다.
<cite>	HTML <cite> 요소는 저작물의 출처를 표기할 때 사용하며, 제목을 반드시 포함해야 합니다.
<code>	HTML <code> 요소는 짧은 코드 조각을 나타내는 스타일을 사용해 자신의 콘텐츠를 표시합니다.
<data>	HTML <data> 요소는 주어진 콘텐츠를 기계가 읽을 수 있는 해석본과 연결합니다.
<dfn>	HTML <dfn> 요소는 현재 맥락이나 문장에서 정의하고 있는 용어를 나타냅니다.
<em>	HTML <em> 요소는 텍스트의 강세를 나타냅니다. <em> 요소를 중첩하면 더 큰 강세를 뜻하게 됩니다.
<i>	HTML <i> 요소는 텍스트에서 어떤 이유로 주위와 구분해야 하는 부분을 나타냅니다.
<kbd>	HTML <kbd> 요소는 키보드 입력, 음성 입력 등 임의의 장치를 사용한 사용자의 입력을 나타냅니다.
<mark>	HTML <mark> 요소는 현재 맥락에 관련이 깊거나 중요해 표시 또는 하이라이트한 부분을 나타냅니다.
<q>	HTML <q>요소는 둘러싼 텍스트가 짧은 인라인 인용문이라는것을 나타냅니다.
<rp>	HTML <rp> 요소는 ruby 요소를 사용한 루비 주석을 지원하지 않는 경우 보여줄 괄호를 제공할 때 사용합니다.
<rt>	HTML <rt> 요소는 동아시아 문자의 루비 주석에서 발음, 번역 등을 나타내는 텍스트 부분을 지정합니다.
<ruby>	HTML <ruby> 요소는 루비 주석을 나타냅니다. 루비 주석은 동아시아 문자의 발음을 표기할 때 사용합니다.
<s>	HTML <s> 요소는 글자에 취소선, 즉 글자를 가로지르는 선을 그립니다.
<samp>	HTML <samp> 요소는 컴퓨터 프로그램 출력의 예시(혹은 인용문)를 나타냅니다.
<small>	HTML <small> 요소는 덧붙이는 글이나, 저작권과 법률 표기 등의 작은 텍스트를 나타냅니다.
<span>	HTML <span> 요소는 구문 콘텐츠를 위한 통용 인라인 컨테이너로, 본질적으로는 아무것도 나타내지 않습니다. 스타일을 적용하기 위해서, 또는 lang 등 어떤 특성의 값을 서로 공유하는 요소를 묶을 때 사용할 수 있습니다.
<strong>	HTML <strong> 요소는 중대하거나 긴급한 콘텐츠를 나타냅니다. 보통 브라우저는 굵은 글씨로 표시합니다.
<sub>	HTML <sub> 요소는 활자 배치를 아래 첨자로 해야 하는 인라인 텍스트를 지정합니다.
<sup>	HTML <sup> 요소는 활자 배치를 위 첨자로 해야 하는 인라인 텍스트를 지정합니다.
<time>	HTML <time> 요소는 시간의 특정 지점 또는 구간을 나타냅니다.
<u>	HTML <u> 요소는 글자로 표현하지 않는 주석을 가진 것으로 렌더링 해야 하는 텍스트를 나타냅니다.
<var>	HTM <var> 요소는 수학 표현 또는 프로그래밍에서 변수의 이름을 나타냅니다.
<wbr>	HTML <wbr> 요소는 현재 요소의 줄 바꿈 규칙을 무시하고 브라우저가 줄을 바꿀 수 있는 위치를 나타냅니다.

이미지 & 멀티미디어
HTML은 사진, 오디오, 비디오 등 다양한 멀티미디어 리소스를 지원합니다..

Element	Description
<area>	HTML <area> 요소는 이미지의 핫스팟 영역을 정의하고 hyperlink를 추가할 수 있습니다. map 요소 안에서만 사용할 수 있습니다.
<audio>	HTML <audio> 요소는 문서에 소리 콘텐츠를 포함할 때 사용합니다.
<img>	HTML <img> 요소는 문서에 이미지를 넣습니다.
<map>	HTML <map> 요소는 area 요소와 함께 이미지 맵(클릭 가능한 링크 영역)을 정의할 때 사용합니다.
<track>	HTML <track> 요소는 미디어 요소(audio, video)의 자식으로서, 자막 등 시간별 텍스트 트랙(시간 기반 데이터)를 지정할 때 사용합니다.
<video>	HTML <video> 요소는 비디오 플레이백을 지원하는 미디어 플레이어를 문서에 삽입합니다.
내장 콘텐츠
HTML은 일반적인 멀티미디어 콘텐츠 외에도 다양한 종류의 기타 콘텐츠를 포함할 수 있습니다.

Element	Description
<embed>	HTML <embed> 요소는 외부 어플리케이션이나 대화형 컨텐츠와의 통합점을 나타냅니다.
<iframe>	HTML <iframe> 요소는 중첩 browsing context을 나타내는 요소로, 현재 문서 안에 다른 HTML 페이지를 삽입합니다.
<object>	HTML <object> 요소는 이미지나, 중첩된 브라우저 컨텍스트, 플러그인에 의해 다뤄질수 있는 리소스와 같은 외부 리소스를 나타냅니다.
<param>	HTML <param> 요소는 object 요소의 매개변수를 정의합니다.